WWWWWWWWWWWWWWWWWWWWWWWWW
W                       W
W                       W
W                       W
W                       W
W                       W
W                       W
W                       W
W                       W
W                       W
W                       W
W                       W
W                       W
W                       W
W                       W
W                       W
W                       W
W                       W
W                       W
W                       W
W                       W
W                       W
W          WWW          W
W          WSW          W
W         .....         W
W                       W
W          .W.          W
W.WWWWWWWWW.W.WWWWWWWWW.W
W.......................W
WWWWWWWWWWWWWWWWWWWWWWWWW